..******************
***...............C*
*.P...******.*.*.*.*
*.............Z....*
*****.*.*.****.***.*
*.......*....Z.....*
*******.*.***.*.****
*...Z...*.*.*.*.*..*
**.*.**.*.***.*.*..*
*..C.....Z....*.*..*
***.*.*.*.......*..*
*.......*******.*..*
*******.........****
*.......*******...E*
*******...Z.....**.*
*C....*.**.****.**.*
*..*..*..*.*.......*
*.Z...*..*.*.*******
*.........C*....Z..*
********************