..******************
***.....*.......*..*
*.P.....*.*.***.*..*
*.......*.*...*.*..*
***.***.*.*.C.*.*..*
*.*.*...*.*.....*..*
*.*.*.***.*****.****
*.*................*
***.*.*********.*..*
*Z..*...*..Z..*.*..*
*****.*.*..*..*.*..*
*C....*....*....*..*
*****.*.*******.*..*
*...*.*.........*.C*
*.C.*.*******.*.****
*...*........Z*....*
*...*.*******.******
*...*.*.......*....*
*...........*E*....*
********************