..******************
***.....*.......*..*
*.P.....*.*.***.*..*
*.......*.*...*....*
***.***.*.*.C.*..Z.*
*.*.*...*.*.....*..*
*.*.*.***.*****.****
*.*..Z.............*
***.*.*********.*..*
*...*...*..Z..*.*..*
*****.*.*..*..*.*..*
*C....*....*....*..*
*****.*.*******.*..*
*...*.*.........*.C*
*.C.*.*******.*.****
*...*........Z*....*
*...*.*******.******
*...*Z*.......*....*
*...........*E*....*
********************