********************
*.......*.......*..*
*.P.....*.*.***.*..*
*.......*.*...*.*..*
***.***.*.*.C.*.*..*
*.*.*...*.*.....*..*
*.*.*.***.*****.****
*.*................*
***.*.*********.*..*
*Z..*...*..Z..*.*..*
*****.*.*..*..*.*..*
*C....*.Z..*....*..*
*****.*.*******.*..*
*...*.*.........*.C*
*.C.*.*******.*.****
*...*.........*....*
*...*.*******.******
*...*.*.....*.*....*
*.....*.Z...*.*....*
*************E******