..******************
***...............C*
*.P...******.*.*.*.*
*.............Z....*
*****.*.*.****.***.*
*.......*..........*
*******.*.***.*.****
*.......*.*.*.*.*..*
**.*.**.*.***.*.*..*
*..C.....Z....*.*..*
***.*.*.*.......*..*
*.......*******.*..*
*******.........****
*.......*******...E*
*******...Z.....**.*
*C....*.**.****.**.*
*..*..*..*.*.......*
*.....*..*.*.*******
*.........C*.......*
********************